10 10
.f........
...f..f...
.f........
.....f....
..........
.......a..
..........
........h.
..........
s.........
